########################################
########################################
########################################
########################################
########################################
########################################
########################################
########################################
########################################
########################################
########################################
########################################
#################.######################
###########..##.............############
###########.#...............############
###########.................############
3x3
4x4
5x3
4x2
