########################################
########################################
########################################
########################################
############...............#############
###........................#############
............................############
............................############
..............................##########
..####........................##########
######........................##########
######........................##########
######.......###########################
########################################
########################################
########################################
4x5
5x6
6x5
5x4
